{
  "totalChests": 1,
  "totalMonsters": 1,
  "map": [
    "####################",
    "#                  #",
    "#                ^ #",
    "#            S     #",
    "#            S  c  #",
    "#   BbbbbB   SSSSSS#",
    "#                  #",
    "#        s        @#",
    "#c   @   s         #",
    "#        s         #",
    "#            @    C#",
    "####################"
  ]
}