{
  "totalChests": 3,
  "totalMonsters": 4,
  "map": [
    "###################",
    "#@  C   BB  cc    #",
    "#   bb  @    @    #",
    "#  @      s @  cc #",
    "#    S@         * #",
    "# cc  @    @      #",
    "###################"
  ]
}