{
  "totalChests": 3,
  "totalMonsters": 4,
  "map": [
    "####################",
    "#@  C   B   cc     #",
    "#  b    @    @     #",
    "#  @      s @  cc  #",
    "#    S@         ^  #",
    "#                  #",
    "#                  #",
    "#                  #",
    "#                  #",
    "#                  #",
    "#                  #",
    "####################"
  ]
}