{
  "totalChests": 3,
  "totalMonsters": 4,
  "map": [
    "####################",
    "#@  C       cc     #",
    "#  b    @    @     #",
    "#         s @  cc  #",
    "#    S          ^  #",
    "#        B         #",
    "#  @  c      @     #",
    "#    @    c        #",
    "#           c      #",
    "#    c           @ #",
    "#        @         #",
    "####################"
  ]
}