{
  "totalChests": 3,
  "totalMonsters": 4,
  "map": [
    "####################",
    "#   C       cc   ^ #",
    "#  b               #",
    "#         s    cc  #",
    "#    S      @      #",
    "#        B      b  #",
    "#  @  b            #",
    "#         c   @    #",
    "#  c        c   S  #",
    "# B  c             #",
    "#     @       B    #",
    "####################"
  ]
}