###################
#   C   BB  cc    #
#   bb            #
#         s       #
#    S            #
#                 #
###################
