totalMonsters=4
map=
###################
#@  C   BB  cc    #
#   bb  @    @    #
#  @      s @     #
#    S@         * #
#     @    @      #
###################