{
  "totalChests": 2,
  "totalMonsters": 5,
  "map": [
    "####################",
    "#c@              @c#",
    "#@                @#",
    "#                  #",
    "#       B  B       #",
    "#       b  b       #",
    "#       bc^b       #",
    "#       BbbB       #",
    "#                  #",
    "#@                @#",
    "#c@              @C#",
    "####################"
  ]
}